┌─────────────┬───────┬───┬───────┬───────────────┐
│             │       │   │       │               │
│ ┌────────── │ ┌───┐ │ │ │ ┌───┐ │ ────────────┐ │
│ │           │ │   │ │ │ │ │   │ │             │ │
│ │ ──────────┘ │ │ │ │ │ │ │ │ │ └───────────┐ │ │
│ │             │ │ │   │   │ │ │             │ │ │
│ ├─────────────┘ │ ├───┴───┤ │ └──────────── │ │ │
│ │               │ │         │               │ │ │
│ │ ─────┬────────┘ │ ┌───┐ │ └──────────┬────┘ │ │
│ │      │          │ │   │ │            │      │ │
│ └────┐ │ ┌────────┘ │ │ │ └──────────┐ │ ┌────┘ │
│      │ │ │          │ │ │            │ │ │      │
├───── │ │ │ ┌──────┬─┘ │ └──┬───────┐ │ │ │ ─────┤
│      │ │ │ │      │   │    │       │ │ │ │      │
│ ┌────┘ │ │ │ ┌─── │ ──┼──  │ ────┐ │ │ │ └────┐ │
│ │      │ │ │ │    │   │    │     │ │ │ │      │ │
│ │ ┌────┘ │ │ │ ┌──┴── │ ───┴───┐ │ │ │ └────┐ │ │
│ │ │      │ │ │ │      │        │ │ │ │      │ │ │
│ │ │ ─────┘ │ │ │ ┌────┼──────┐ │ │ │ ├───── │ │ │
│ │ │        │ │ │ │    │      │ │ │ │ │      │ │ │
│ │ └────┬───┘ │ │ │ ┌─ │ ───┐ │ │ │ │ │ ┌────┘ │ │
│ │      │     │   │ │  │    │   │ │   │ │      │ │
│ └────┐ │ ────┼───┘ │ ┌┴──┐ ├───┘ ├───┘ │ ┌────┘ │
│      │ │     │     │ │ ? │ │     │     │ │      │
├───── │ ├──── │ ────┤ │   │ │ ────┤ ────┤ │ ─────┤
│      │ │     │     │ └┐ ┌┘ │     │     │ │      │
│ ┌────┘ │ ────┼───┐ │  │ │  ├───┐ ├───┐ │ └────┐ │
│ │      │     │   │ └┐ │ │  │   │ │   │ │      │ │
│ │ ┌────┴───┐ │ │ │  │ │ │ ─┘ │ │ │ │ │ └────┐ │ │
│ │ │        │ │ │ │  │ │ │    │ │ │ │ │      │ │ │
│ │ │ ─────┐ │ │ │ └─ │ │ └──┬─┘ │ │ │ ├───── │ │ │
│ │ │      │ │ │ │    │ │        │ │ │ │      │ │ │
│ │ └────┐ │ │ │ └────┤ ├─── │ ──┘ │ │ │ ┌────┘ │ │
│ │      │ │ │ │      │ │    │     │ │ │ │      │ │
│ └────┐ │ │ │ └───── │ │ ───┴─────┘ │ │ │ ┌────┘ │
│      │ │ │ │        │ │            │ │ │ │      │
├───── │ │ │ └────────┘ └┬────────┬──┘ │ │ │ ─────┤
│      │ │ │             │        │    │ │ │      │
│ ┌────┘ │ └─────┬──── │ │ ┌───── │ ───┤ │ └────┐ │
│ │      │       │     │ │ │      │    │ │      │ │
│ │ ─────┴──┬─── ├     │ │ │ ─────┼─── │ └────┐ │ │
│ │         │    │     │ │ │      │    │      │ │ │
│ ├──────── │ ───┼     │ │ ├───── │ ───┴───── │ │ │
│ │         │    │     │ │ │      │           │ │ │
│ │ ────────┼─── ├     │ │ │ ─────┴────  ─────┘ │ │
│ │         │    │     │ │ │                    │ │
│ └──────── │ ───┴──── │ │ └────────────────────┘ │
│           │          │ │                        │
└───────────┴──────────┘ └────────────────────────┘
